XZZ ZZZZZZ
XYXXX XXXX
XX Y XXYXX
ZXYXX   XX
XX YXXZXXX
ZX   Y XXX
XZYZXYXXYX
ZXXZXYX XX
X XX YXZXY
YZXYXXYXYX
