X        X
ZXZXX XYXX
XX XXXYXYX
XYXXX   XX
XX XZXXYXZ
ZX     XXX
XXXX XZXZX
XYXYXYX YZ
X XX XYXYX
XYXYZXYXYX