Z        Z
ZZZZZ ZYZZ
ZZ ZZZYZYZ
ZYZZZ   ZZ
ZZ ZZZZYZZ
ZZ     ZZZ
ZZZZ ZZZZZ
ZYZYZYZ YZ
Z ZZ ZYZYZ
ZYZYZZYZYZ